 #    #      
  #    #     
###  ###      


 #    #      
  #    #     
###  ###      


 #    #      
  #    #     
###  ###      


 #    #      
  #    #     
###  ###      


 #    #      
  #    #     
###  ###      
            

